0000000000
0000000000
0000000000
0000000000
0011111100
0000110000
0000110000
0000110000
0000110000
0000110000