0001000000
0100101100
0110000100
0000110000
0101111100
0000101000
1110000010
0000001000
0001001000
0001001000